2 2 2 2 2 2 2 2 2 2 2 2 1 1 2 2
2 2 2 2 2 2 2 2 2 2 2 2 1 1 2 2
2 2 2 2 2 2 2 6 6 6 2 2 1 1 2 2
2 4 4 3 3 3 2 6 6 6 7 7 1 1 2 2
2 4 4 3 3 3 2 6 6 6 0 0 0 0 0 2
2 0 0 0 0 0 0 0 0 0 0 0 0 0 0 2
2 0 0 0 0 0 0 0 0 0 0 0 0 0 0 2
2 0 0 0 0 0 0 0 0 0 0 0 0 0 0 2
2 0 0 0 0 0 0 0 0 0 0 0 0 0 0 2
2 0 0 0 0 0 0 0 0 0 0 0 0 0 0 2
2 0 0 0 0 0 0 0 0 0 0 5 5 5 5 2
2 0 0 0 0 0 0 0 0 0 0 5 5 5 5 2
2 0 0 0 0 0 0 0 0 0 0 5 5 5 5 2
2 0 0 0 0 0 0 0 0 0 0 5 5 5 5 2
2 0 0 0 0 0 0 0 0 0 0 5 5 5 5 2
2 2 2 2 2 2 2 2 2 2 2 2 2 2 2 2