9 9 9 9 9 9 9 9 9 9 9 9 8 8 9 9
9 9 9 9 9 9 9 9 9 9 9 9 8 8 9 9
9 9 9 9 9 9 9 9 13 13 9 9 8 8 9 9
9 11 11 10 10 10 9 13 13 13 9 9 8 8 9 9
9 11 11 10 10 10 9 13 13 13 9 9 14 14 9 9
9 11 11 10 10 10 9 13 13 13 14 14 14 14 9 9
9 14 14 14 14 14 14 14 14 14 14 14 14 14 14 9
9 14 14 14 14 14 14 14 14 14 14 14 14 14 14 9
9 14 14 14 14 14 14 14 14 14 14 14 14 14 14 9
9 14 14 14 14 14 14 14 14 14 14 14 14 14 14 9
9 14 14 14 14 14 14 14 14 14 14 14 12 12 12 9
9 14 14 14 14 14 14 14 14 14 14 14 12 12 12 9
9 14 14 14 14 14 14 14 14 14 14 14 12 12 12 9
9 14 14 14 14 14 14 14 14 14 14 14 12 12 12 9
9 14 14 14 14 14 14 14 14 14 14 14 12 12 12 9
9 9 9 9 9 9 9 9 9 9 9 9 9 9 9 9