2 2 2 2 2 2 2 2 2 2 2 2 1 1 2 2
2 2 2 3 3 3 2 2 2 2 2 2 1 1 2 2
2 2 2 0 0 0 2 2 2 2 7 7 0 0 2 2
2 0 0 0 0 0 0 0 0 0 0 0 0 0 0 2
2 0 0 0 0 0 0 0 0 0 0 0 0 0 0 2
2 5 5 0 5 5 0 0 5 5 0 0 0 0 0 2
2 5 5 0 5 5 0 0 5 5 0 0 0 0 0 2
2 4 4 4 4 4 4 4 4 4 4 0 0 0 6 2
2 4 4 4 4 4 4 4 4 4 4 0 0 0 6 2
2 4 4 4 4 4 4 4 4 4 4 0 0 0 6 2
2 4 4 4 4 4 4 4 4 4 4 0 0 0 6 2
2 4 4 4 4 4 4 4 4 4 4 0 0 0 6 2
2 5 5 4 5 5 4 4 5 5 4 0 0 0 0 2
2 5 5 0 5 5 0 0 5 5 0 0 0 0 0 2
2 0 0 0 0 0 0 0 0 0 0 0 0 0 0 2
2 2 2 2 2 2 2 2 2 2 2 2 2 2 2 2