10 10 10 10 10 10 10 10 10 10 10 10 16 16 10 10
10 10 10 10 10 10 10 10 10 10 10 10 16 16 10 10
10 10 10 10 10 10 10 14 14 14 10 10 16 16 10 10
10 12 12 11 11 11 10 14 14 14 10 10 16 16 10 10
10 12 12 11 11 11 10 14 14 14 15 15 15 15 15 10
10 15 15 15 15 15 15 15 15 15 15 15 15 15 15 10
10 15 15 15 15 15 15 15 15 15 15 15 15 15 15 10
10 15 15 15 15 15 15 15 15 15 15 15 15 15 15 10
10 15 15 15 15 15 15 15 15 15 15 15 15 15 15 10
10 15 15 15 15 15 15 15 15 15 15 15 15 15 15 10
10 15 15 15 15 15 15 15 15 15 15 13 13 13 13 10
10 15 15 15 15 15 15 15 15 15 15 13 13 13 13 10
10 15 15 15 15 15 15 15 15 15 15 13 13 13 13 10
10 15 15 15 15 15 15 15 15 15 15 13 13 13 13 10
10 15 15 15 15 15 15 15 15 15 15 13 13 13 13 10
10 10 10 10 10 10 10 10 10 10 10 10 10 10 10 10